ПАА	ВЫПА	Аэропорт Хпа-Ан [1]	Хпа-Ан , Мьянма		
ПАБ	ВЕБУ	Биласпур аэропорт	Биласпур , Чхаттисгарх , Индия		
ПКК	МПМГ	Международный аэропорт Альбрук «Маркос А. Гелаберт»	Панама-Сити , Панама		
ПАД	ЕДЛП	Падерборн Липпштадт аэропорт	Падерборн / Липпштадт , Северный Рейн-Вестфалия , Германия		
ПАЭ	КПАЭ	Пейн Филд (аэропорт округа Снохомиш)	Эверетт , Вашингтон , США		
ПАФ	ХУПА	Аэродром Пакуба	Пакуба , Уганда		
ПАГ	РПМП	Пагадиан аэропорт	Пагадиан , Филиппины		
ПАУ	КПАХ	Региональный аэропорт Баркли	Падука , Кентукки , США		
ПАЖ	ОППК	Аэропорт Парачинар [1]	Парачинар , Пакистан		
ПАК	PHPA	Порт Аллен: аэропорт	Ханапепе , Гавайи , США		
ПАЛ	СКПК	Авиабаза капитана Хермана Олано Морено [1]	Паланкеро , Колумбия		
ПАМ	КПАМ	База ВВС Тиндалл	Панама-Сити , Флорида , США		
ПАО	КПАО	Аэропорт Пало-Альто (аэропорт округа Санта-Клара)	Пало-Альто , Калифорния , США		
ПАП	МТПП	Международный аэропорт Туссен-Лувертюр	Порт-о-Пренс , Гаити		
PAQ	ПААК	Муниципальный аэропорт Палмер	Палмер , Аляска , США		
ПАС	LGPA	Национальный аэропорт Пароса	Парос , Греция		
ПАТ	ВЭПТ	Аэропорт Лок Наяк Джаяпракаш	Патна , Бихар , Индия		
ПАУ	ВЫПК	Аэропорт Паук [1]	Паук , Мьянма		
ПАВ	СБУФ	Аэропорт Паулу Афонсу [1]	Паулу Афонсу , Баия , Бразилия		
ПАКС    МТРХ	Аэропорт Порт-де-Пе [1]	Порт-де-Пе , Гаити		
ПЛА	ВБКП	Аэропорт Памол [1]	Памол , Сабах , Малайзия		
ПАЗ	ММПА	Национальный аэропорт Эль-Тахин	Поса-Рика , Веракрус , Мексика		
ПББ	ССПН	Аэропорт Паранаиба [1]	Паранаиба , Мату-Гросу-ду-Сул , Бразилия		
ПБД	ВАПР	Аэропорт Порбандар [1]	Порбандар , Гуджарат , Индия		
ПБЕ	СКПР	Аэропорт Морела [1] (аэропорт Пуэрто Беррио)	Пуэрто Беррио , Колумбия		
ПБФ	КПБФ	Грайдер Филд	Пайн-Блафф , Арканзас , США		
ПБГ	КПБГ	Международный аэропорт Платтсбург	Платтсбург , Нью-Йорк , США		
ПБХ	ВКПР	Международный аэропорт Паро	Паро , Бутан		
ПБИ	КПБИ	Международный аэропорт Палм-Бич	Уэст-Палм-Бич , Флорида , США		
ПБЖ	НВСИ	Аэропорт Паама [1]	Паама , Вануату		
ПБЛ	СВПК	Аэропорт Бартоломе Салом [1]	Пуэрто-Кабельо , Венесуэла		
ПБМ	СМДЖП	Международный аэропорт Йохан Адольф Пенгель	Парамарибо , Суринам		
ПБН	ФНПА	Аэропорт Порту-Амбоим [1]	Порту-Амбоим , Ангола		
ПБО	ЯПБО	Аэропорт Парабурду	Парабурду , Западная Австралия , Австралия		
ПБП	МРТ	Аэропорт Пунта Ислита	Пунта-Ислита , Коста-Рика		
ПБК	SWPM	Аэропорт Пимента Буэно [1]	Пимента Буэно , Рондония , Бразилия		
ПБР	МГПБ	Аэропорт Пуэрто-Барриос [1]	Пуэрто-Барриос , Гватемала		
ПБУ	ВЫПТ	Аэропорт Путао [1]	Путао , Мьянма		
ПБВ	СВПГ	Аэропорт Порту-дус-Гаушос	Порту-дус-Гаушос , Мату-Гросу , Бразилия		
АТС	СВПК	Аэропорт Фазенда Пирагуасу	Порту-Алегри-ду-Норти , Мату-Гросу , Бразилия		
ПБЗ	ФАПГ	Аэропорт Плеттенберг Бэй [1]	Плеттенберг Бэй , Южная Африка		
СПС	ПАОК	Аэропорт Портидж-Крик (FAA: A14)	Портидж-Крик , Аляска , США		
ПКД	КПДК	Муниципальный аэропорт Прейри-дю-Шен (FAA: PDC)	Прейри-дю-Чьен , Висконсин , США		
ПКФ	ФАПС	Аэропорт Почефструм [1]	Почефструм , Южная Африка		
ПЧ	МХПК	Аэропорт Паласиос [1]	Паласиос , Гондурас		
ПКЛ	СПЛК	Международный аэропорт имени капитана ФАП Давида Абенсура Ренхифо	Пукальпа , Перу		
ПКН	НЗОК	Аэродром Пиктон	Пиктон , Новая Зеландия		
ПКО	ММПЛ	Взлетно-посадочная полоса Пунта-Колорада [1]	Ла-Рибера , Южная Нижняя Калифорния , Мексика		
PCP	ФППР	Аэропорт Принсипи [1]	Остров Принсипи , Сан-Томе и Принсипи		
ПЦР	СКПК	Аэропорт Херман Олано	Пуэрто Карреньо , Колумбия		
ПКС	СНПК	Аэропорт Пикос [1]	Пикос , Пиауи , Бразилия		
КПК	СКПД	Аэропорт Обандо	Пуэрто-Инирида , Колумбия		
ПДК	СЗВК	Муэо/Никель аэропорт	Муэо , Новая Каледония		
ПДД	FQPO	Аэропорт Понта-ду-Ору [1]	Понта-ду-Ору , Мозамбик		
ПДЭ	ЯПДИ	Аэропорт Панди Панди [1]	Станция Панди Панди , Южная Австралия , Австралия		
PDF	СИАЖ	Аэропорт Фаз Тауа [1]	Прадо , Баия , Бразилия		
ПДГ	ВИПТ	Международный аэропорт Минангкабау	Паданг , Индонезия		
ДПК	КПДК	Аэропорт ДеКалб – Пичтри	Атланта , Джорджия , США		
ПДЛ	ЛППД	Аэропорт Жуан Паулу II	Понта-Делгада , Азорские острова , Португалия		
ПДО	WIPQ	Аэропорт Пендопо [1]	Пендопо , Индонезия		
ПРП	СУЛС	Международный аэропорт Капитан де Корбета Карлос А. Курбело	Пунта-дель-Эсте , Уругвай		
ПДС	ММПГ	Международный аэропорт Пьедрас Неграс	Пьедрас-Неграс , Коауила , Мексика		
ПДУ	ГУПУ	Международный аэропорт Тайдео Ларре Борхес	Пайсанду , Уругвай		
ПДВ	ЛБПД	Аэропорт Пловдив	Пловдив , Болгария		
ПДКС КПДКС	Международный аэропорт Портленда	Портленд , Орегон , США		
ПДЗ	СВПЭ	Аэропорт Педерналес [1]	Педерналес , Венесуэла		
ПЭА	ЯПШ	Аэропорт Пеннешоу [1]	Пеннешоу , Южная Австралия , Австралия		
ПЭД	ЛКПД	Аэропорт Пардубице	Пардубице , Чехия		
ПИЭ	УСПП	Международный аэропорт Пермь (Аэропорт Большое Савино)	Пермь , Пермский край , Россия		
ПЭФ	ЭДКП	Аэродром Пенемюнде [1]	Пенемюнде , Мекленбург-Передняя Померания , Германия		
ПЭГ	ЛИРЗ	Перуджа Сан-Франческо д'Ассизи – международный аэропорт Умбрии	Перуджа , Умбрия , Италия		
ПЕХ	САЗП	Комодоро Педро Занни: аэропорт	Пеуахо , Буэнос-Айрес , Аргентина		
ПЭИ	СКПЭ	Международный аэропорт Матеканья	Перейра , Колумбия		
ПЭК	ЗБАА	Международный аэропорт Пекин Столичный	Пекин , Китай		
ПЭЛ	FXPG	Аэропорт Пеланенг [1]	Пеланенг , Лесото		
ПЕМ	СПТУ	Международный аэропорт Падре Альдамис	Пуэрто Мальдонадо , Перу		
ПКП		Аэропорт Пеппименарти [1]	Пеппименарти , Северная территория , Австралия		
ПКВ	КПЭК	Муниципальный аэропорт Пекос	Пекос , Техас , США		
ПЕР	ЯППХ	Перт аэропорт	Перт , Западная Австралия , Австралия		
ПЭС	УЛПБ	Аэропорт Петрозаводска (Аэропорт Бесовец)	Петрозаводск , Карелия , Россия.		
ПЭУ	МХПЛ	Аэропорт Пуэрто Лемпира [1]	Пуэрто Лемпира , Гондурас		
ПЭВ	КТЭ	Международный аэропорт Печ-Погань [1]	Печ , Венгрия		
ПЕВ	ОППС	Международный аэропорт Бача Хан	Пешавар , Пакистан		
ПЕКС	УУЙП	Аэропорт Печора	Печора , Республика Коми , Россия		
ПЭЗ	УВЭС	Аэропорт Пензы (Аэропорт Терновка)	Пенза , Пензенская область , Россия		
ПФБ	СБПФ	Аэропорт Лауро Курц	Пассо Фундо , Риу-Гранди-ду-Сул , Бразилия		
ПФК	КПФК	Государственный аэропорт Пасифик-Сити	Пасифик-Сити , Орегон , США		
ПФЖ	БИПА	Аэропорт Патрексфьордюр	Патрексфьордур , Исландия		
ПФО	LCPH	Международный аэропорт Пафоса	Пафос , Кипр		
PFQ	ОИТП	Аэропорт Парсабад-Моган [1]	Парсабад , Иран		
ПФР	ФЗВС	Аэропорт Илебо [1]	Илебо , Демократическая Республика Конго		
ПГА	КПГА	Муниципальный аэропорт Пейдж	Пейдж , Аризона , США		
ПГК		 округа Грант (FAA: W99)	Петербург , Западная Вирджиния , США		
ПГД	КПГД	Аэропорт Пунта Горда	Пунта Горда , Флорида , США		
ПГЕ		Йегепа аэропорт	Йегепа , Папуа-Новая Гвинея		
ПГФ	ЛФМП	Аэропорт Перпиньян-Ривесальт	Перпиньян , Лангедок-Руссильон , Франция		
ПГХ	ВИПТ	Аэропорт Пантнагар [1]	Пантнагар , Уттаракханд , Индия		
ЗГУ	ФНЧ	Аэропорт Читато [1]	Читато , Ангола		
ПГК	ВИПК	Аэропорт Депати Амир [1]	Пангкал Пинанг (Пангкалпинанг), Индонезия		
ПГЛ	КПКЛ	Международный аэропорт Трент Лотт (FAA: PQL)	Паскагула , Миссисипи , США		
ПГМ		Аэропорт Порт-Грэм	Порт-Грэм , Аляска , США		
ПГН		Аэропорт Пангиа [1]	Пангиа , Папуа-Новая Гвинея		
ПГО	КПСО	Стивенс Филд (ФАУ: PSO)	Пагоса-Спрингс , Колорадо , США		
ПГК	ВЭМ	Аэропорт Були	Були , Северное Малуку , Индонезия		
РГР	КПГР	Кирк Филд	Парагулд , Арканзас , США		
ПГС		Аэропорт Гранд-Каньон-Кавернс (FAA: L37)	Пич-Спрингс , Аризона , США		
ПГУ	ОИБП	Аэропорт Персидского залива [1]	Асалуе (Асалойе), Иран		
ПГВ	КПГВ	Аэропорт Питт-Гринвилл	Гринвилл , Северная Каролина , США		
PGX	ЛФБКС	Аэропорт Перигё-Бассийяк	Перигё , Аквитания , Франция		
ПГЗ	ССЗВ	Граф. Аэропорт Антонио Амилтон Беральдо [1]	Понта-Гросса , Парана , Бразилия		
ПГА	ВВПР	Авиабаза Фан Ранг [1]	Фан Ранг – Тхап Чам , Вьетнам		
ПОБ	СБПБ	Международный аэропорт Парнаиба-Префейто имени доктора Жоау Силва Фильо	Парнаиба , Пиауи , Бразилия		
ПМСП	ДНПО	Международный аэропорт Порт-Харкорт	Порт-Харкорт , Нигерия		
КАНДИДАТ НАУК	КПХД	Гарри Клевер Филд	Нью-Филадельфия , Огайо , США		
ПТО	YPPD	Международный аэропорт Порт-Хедленд	Порт-Хедленд , Западная Австралия , Австралия		
ПХФ	КПХФ	Ньюпорт-Ньюс / Международный аэропорт Уильямсбург	Ньюпорт-Ньюс / Вильямсбург , Вирджиния , США		
ПХГ		Аэропорт Порт-Харкорт-Сити [1]	Порт-Харкорт , Нигерия		
ФИ	СНЙЕ	Аэропорт Пиньейру [1]	Пиньейру , Мараньян , Бразилия		
ПХК	КПХК	Аэропорт Палм-Бич Каунти-Глэйдс	Пахоки , Флорида , США		
ПХЛ	КПХЛ	Международный аэропорт Филадельфии	Филадельфия , Пенсильвания , США		
PHN	КПХН	Международный аэропорт округа Сент-Клер	Порт-Гурон , Мичиган , США		
ФО	ПАПО	Аэропорт Пойнт Хоуп	Пойнт-Хоуп , Аляска , США		
PHP	КПХП	Аэропорт Филип	Филип , Южная Дакота , США		
штаб-квартира	ЮТМО	Аэропорт Монумент [1]	Фосфат-Хилл , Квинсленд , Австралия		
ПХР	НФНД	Аэропорт Пасифик-Харбор [1]	Пасифик-Харбор , Фиджи		
ПХС	ВТПП	Пхитсанулок аэропорт	Пхитсанулок , Таиланд		
ПХТ	КПХТ	Аэропорт Генри Каунти	Пэрис , Теннесси , США		
ПХВ	ФАПГ	Аэропорт Хендрик Ван Эк	Пхалаборва , Южная Африка		
ПХХ	КПХХ	Международный аэропорт Финикс Скай Харбор	Финикс , Аризона , США		
ФИЗИЧЕСКИЙ	ВТПБ	Пхетчабун аэропорт	Пхетчабун , Таиланд		
ПИА	КПИА	Международный аэропорт имени генерала Уэйна А. Даунинга в Пеории	Пеория , Иллинойс , США		
ПИБ	КПИБ	Региональный аэропорт Хаттисберг-Лорел	Хаттисберг / Лорел , Миссисипи , США		
ПОС	MBPI	Аэропорт Пайн-Кей [1]	Пайн-Кей , Британская заморская территория островов Тёркс и Кайкос		
ПИРОГ	КПИЕ	Международный аэропорт Сент-Пит-Клируотер	Санкт-Петербург / Клируотер , США		
ПИФ	РЦДЦ [2]	Южный аэропорт Пиндун [1]	Город Пиндун , Тайвань		
PIH	КПИХ	Региональный аэропорт Покателло	Покателло , Айдахо , США		
ПИК	ЕГПК	Глазго Прествик аэропорт	Глазго , Шотландия , Великобритания		
ПИЛ	СГПИ	Аэропорт Карлос Мигель Хименес	Пилар , Парагвай		
ПИМ	КПИМ	Аэропорт Харрис Каунти	Пайн-Маунтин , Джорджия , США		
ПРИКОЛОТЬ	SWPI	Аэропорт Жулио Белен	Паринтинс , Амазонас , Бразилия		
ПИО	СПСО	Капитан ФАП Ренан Элиас Оливера Аэропорт	Писко , Перу		
ПИП	ПАПН	Аэропорт Пилот-Пойнт (FAA: PNP)	Пилот-Пойнт , Аляска , США		
PIQ		Аэропорт Пипиллипай [1]	Пипиллипай , Гайана		
ПИР	КПИР	Региональный аэропорт Пьер	Пьер , Южная Дакота , США		
ПИС	ЛФБИ	Аэропорт Пуатье-Биар	Пуатье , Пуату-Шаранта , Франция		
ЯМА	КПИТ	Международный аэропорт Питтсбурга	Питтсбург , Пенсильвания , США		
ОРП	ШПОРА	Международный аэропорт имени капитана ФАП Гильермо Конча Иберико	Пьюра , Перу		
ПИВ	СНПКС	Аэропорт Пирапора [1]	Пирапора , Минас-Жерайс , Бразилия		
ПИВ	ЦЗМН	Аэропорт Пиквитоней [1]	Пиквитоней , Манитоба , Канада		
ПИКС	ЛППИ	Аэропорт Пико	Остров Пику , Азорские острова , Португалия		
ПИЗ	ППИЗ	Аэропорт Пойнт-Лэй LRRS	Пойнт-Лэй , Аляска , США		
ПЯА	ЕСУП	Пайала аэропорт	Пайала , Швеция		
ПИББ	КПАН	Аэропорт Пейсон (FAA: PAN)	Пейсон , Аризона , США		
ПАО	СГПЖ	Международный аэропорт имени доктора Аугусто Роберто Фустера	Педро Хуан Кабальеро , Парагвай		
ПИЖГ	ОППГ	Аэропорт Панджгур	Панджгур , Пакистан		
ПДжМ	МРПЖ	Аэропорт Пуэрто-Хименес	Пуэрто-Хименес , Коста-Рика		
ПКА	ПАПК	Напаскиак аэропорт	Напаскиак , Аляска , США		
ПКБ	КПКБ	Региональный аэропорт Мид-Огайо-Вэлли	Паркерсбург , Западная Вирджиния , США		
ПКС	УГЭС	Аэропорт Петропавловск-Камчатский (Аэропорт Елизово)	Петропавловск-Камчатский , Камчатский край , Россия.		
ПКД	КПКД	Муниципальный аэропорт Парк-Рапидс (Коншок-Филд)	Парк-Рапидс , Миннесота , США		
ПКЕ	ЯПКС	Аэропорт Паркс [1]	Паркс , Новый Южный Уэльс , Австралия		
ПКФ	КПКФ	Муниципальный аэропорт Парк-Фолс	Парк-Фолс , Висконсин , США		
ПКГ	ВМПА	Аэропорт Пангкор [1]	Остров Пангкор , Перак , Малайзия		
ПКХ	ЛГХЛ	Порто Чели аэропорт	Порто Чели (Портохелион), Греция		
ПКЖ	МГПГ	Аэропорт Плайя-Гранде [1]	Плайя-Гранде , Гватемала		
РПК	ВЫПУ	Аэропорт Пакокку [1]	Пакокку , Мьянма		
ПКМ		Аэропорт Порт-Каитума [1]	Порт Кайтума , Гайана		
ПКН	ВАОИ	Аэропорт Искандар [1]	Пангкаланская булочка (Пангкаланбуун), Индонезия		
ПКО	ДББП	Аэропорт Параку	Параку , Бенин		
ПКП	НТГП	Аэропорт Пука-Пука [1]	Пука-Пука , Туамотус , Французская Полинезия		
ПКР	ВНПК	Аэропорт Покхара	Покхара , Непал		
ПКТ	ЯКПТ	Аэродром Порт-Китс	Уэйдай (Порт-Китс), Северная территория , Австралия		
ФКУ	ВИББ	Международный аэропорт Султана Шарифа Касима II	Пеканбару , Индонезия		
ПКВ	УЛОО	Псковский аэропорт	Псков , Псковская область , Россия		
ПКВ	ФБСП	Аэропорт Селеби-Пикве	Селеби-Фикве , Ботсвана		
ПКХ	ЗБАД	Пекинский международный аэропорт Дасин	Пекин , Китай		
ПКИ	ВАГГ	Аэропорт Тджилик Ривут [1]	Палангкарая , Индонезия		
ПКЗ	ВЛПС	Международный аэропорт Паксе	Паксе , Лаос		
НОАК		Аэропорт Планадас [1]	Планадас , Колумбия		
ПЛК		Аэропорт Планета Рика [1]	Планета Рика , Колумбия		
ПЛД	МРЦР	Аэропорт Каррильо [1] (Плайя Самара/Аэропорт Каррильо)	Самара / Пуэрто Каррильо , Коста-Рика		
ПЛЭ		Пайэла аэропорт	Пайэла , Папуа-Новая Гвинея		
ПЛФ	ФТТП	Аэропорт Пала [1]	Пала , Чад		
ЛЖВ	ЭГГД	Плимут Сити аэропорт	Плимут , Англия , Великобритания		
ПЛИ		Аэропорт Палм-Айленд [1]	Палм-Айленд , Сент-Винсент и Гренадины		
ПЛЖ	МЗПЛ	Аэропорт Пласенсия	Пласенсия , Белиз		
ПЛК	КПЛК	Аэропорт М. Грэм Кларк Даунтаун	Пойнт-Лукаут , Миссури , США		
ФАПЧ	СБМН	База ВВС Манаус	Манаус , Амазонас , Бразилия		
ПЛМ	ВИПП	Международный аэропорт Султана Махмуда Бадаруддина II	Палембанг , Индонезия		
злотых	КПЛН	Региональный аэропорт Пеллстон (округ Эммет)	Пеллстон , Мичиган , США		
ООП	ЯПЛК	Порт-Линкольн: аэропорт	Порт-Линкольн , Южная Австралия , Австралия		
ПЛП	МПЛП	Аэропорт капитана Рамона Хатруха [1]	Ла Пальма , Панама		
PLQ	EYPA	Международный аэропорт Паланги	Паланга , Литва		
ПЛР	КПЛР	Аэропорт округа Сент-Клер	Пелл-Сити , Алабама , США		
Пожалуйста	МБПВ	Международный аэропорт Провиденсьялес	Провиденсиалес , Британская заморская территория
острова Тёркс и Кайкос		
ПЛТ	СКПЛ	Платон аэропорт [1]	Платон , Колумбия		
ПЛУ	СББХ	Белу-Оризонти/Пампулья – Аэропорт Карлос Драммонд де Андраде	Белу-Оризонти , Минас-Жерайс , Бразилия		
ПЛВ	УХП	Аэропорт Полтава [1]	Полтава , Украина		
ПЛВ	ВАФФ	Аэропорт Мутиара [1]	Палу , Индонезия		
ПЛХ	УАСС	Аэропорт Семей	Семей , Казахстан		
ПЛИ		Муниципальный аэропорт Плимута (FAA: C65)	Плимут , Индиана , США		
ПЛЗ	ФАПЕ	Аэропорт Порт-Элизабет	Порт-Элизабет , Южная Африка		
ПМА	ПВТЭ	Аэропорт Пемба [1]	Остров Пемба , Танзания		
ПМБ	КПМБ	Муниципальный аэропорт Пембина	Пембина , Северная Дакота , США		
ЧВК	СКЭТ	Эль Тепуаль аэропорт	Пуэрто-Монт , Чили		
ПМД	КПМД	Региональный аэропорт Палмдейл	Палмдейл , Калифорния , США		
ПМФ	ХРОМАТЬ	Аэропорт Пармы (аэропорт Джузеппе Верди)	Парма , Эмилия-Романья , Италия		
ПМГ	СБПП	Международный аэропорт Понта Поран	Понта-Поран , Мату-Гросу-ду-Сул , Бразилия		
ПМХ	КПМХ	Региональный аэропорт Большого Портсмута	Портсмут , Огайо , США		
PMI	ЛЕПА	Аэропорт Пальма де Майорка	Пальма-де-Майорка , Балеарские острова , Испания		
ПМК	ЯПАМ	Аэропорт Палм-Айленд [1]	Палм-Айленд , Квинсленд , Австралия		
ПМЛ	ПААЛ	Аэропорт Порт-Моллер (FAA: 1AK3)	Колд Бэй , Аляска , США		
ПМН		Аэропорт Пумани [1]	Пумани , Папуа-Новая Гвинея		
ОУП	LICJ	Аэропорт Фальконе-Борселлино (аэропорт Пунта Раиси)	Палермо , Сицилия , Италия		
ПМП		Аэропорт Пимага	Пимага , Папуа-Новая Гвинея		
ПМЗ	ЮАРП	Перито Морено аэропорт	Перито Морено , Санта-Крус , Аргентина		
ПМР	НЗПМ	Аэропорт Палмерстон Норт	Пальмерстон-Норт , Новая Зеландия		
ПМС	ОСПР	Пальмира аэропорт	Пальмира (Тадмур), Сирия		
ПЛТ		Аэропорт Парамакатой [1]	Парамакатои , Гайана		
ПМВ	СВМГ	Карибский международный аэропорт Сантьяго Мариньо	Порламар , Венесуэла		
ПМВ	СБПЖ	Аэропорт Пальмас-Бригадейро Лисиас Родригес	Пальмас , Токантинс , Бразилия		
ПМХ		Столичный аэропорт [1] (FAA: 13MA)	Палмер , Массачусетс , США		
ПМИ	СЭВИ	Эль-Техуэльче: аэропорт	Пуэрто-Мадрин , Чубут , Аргентина		
ПМЗ	МРПМ	Пальмар-Сур: аэропорт	Пальмар-Сур , Коста-Рика		
ПНА	ЛЕПП	Памплона аэропорт	Памплона , Наварра , Испания		
ПНБ	СБПН	Национальный аэропорт Порту [1]	Порто Насьональ , Токантинс , Бразилия		
ПНК	КПНК	Региональный аэропорт Понка-Сити	Понка-Сити , Оклахома , США		
ПНД	МЗПГ	Аэропорт Пунта Горда [1]	Пунта Горда , Белиз		
ПНЕ	КПНЕ	Северо-восточный аэропорт Филадельфии	Филадельфия , Пенсильвания , США		
PNG	ССПГ	Аэропорт Сантос-Дюмон [1]	Паранагуа , Парана , Бразилия		
ПНХ	ВДПП	Международный аэропорт Пномпеня	Пномпень , Камбоджа		
ПНИ	ПТПН	Международный аэропорт Понпеи	Понпеи , Федеративные Штаты Микронезии		
ПНЖ		Аэропорт Пэнлай Шахекоу [1]	Пэнлай , Шаньдун , Китай		
ПНК	ВИОО	Супадио аэропорт	Понтианак , Индонезия		
ПНЛ	ЛИКГ	Аэропорт Пантеллерия [1]	Пантеллерия , Сицилия , Италия		
ПНН	КПНН	Муниципальный аэропорт Принстона	Принстон , Мэн , США		
ПНП	АЙГР	Аэропорт Гируа [1]	Попондетта , Папуа-Новая Гвинея		
ПНК	ВАПО	Пуна аэропорт	Пуна , Махараштра , Индия		
бронирование	ФЦПП	Пуэнт-Нуар: аэропорт	Пуэнт-Нуар , Республика Конго		
ПНС	КПНС	Международный аэропорт Пенсакола	Пенсакола , Флорида , США		
ПНТ	СНТ	Аэропорт Теньенте Хулио Галлардо	Пуэрто-Наталес , Чили		
ПНУ		Муниципальный аэропорт Пангитч (FAA: U55)	Пангитч , Юта , США		
ПНВ	ЕЮПП	Авиабаза Паневежис [1] (аэропорт Паюостис)	Паневежис , Литва		
ПНКС	КГИИ	Региональный аэропорт Северного Техаса (FAA: GYI)	Шерман / Денисон , Техас , США	UTC-06:00	март-ноябрь
ПНЙ	ГОЛОСОВАНИЕ	Пудучерри аэропорт	Пондичерри , Пудучерри , Индия		
ПНЗ	СБПЛ	Аэропорт Сенадор Нило Коэльо	Петролина , Пернамбуку , Бразилия		
доверенность на доступ	SBPA	Международный аэропорт Салгаду Филью	Порту-Алегри , Риу-Гранди-ду-Сул , Бразилия		
ПОБ	КПОБ	Поуп Филд (ВВС Поуп)	Форт Либерти , Северная Каролина , США		
POC	КПОК	Брэкетт Филд	Ла Верн , Калифорния , США		
ПОД	ГОСП	Аэропорт Подор	Подор , Сенегал		
ПОЕ	КПОЭ	Армейский аэродром Макс [3]	Форт Джонсон , Луизиана , США		
ПОФ	КПОФ	Муниципальный аэропорт Поплар Блафф	Поплар Блафф , Миссури , США		
ПОГ	ФОГ	Международный аэропорт Порт-Жантиль	Порт-Жантиль , Габон		
ПОХ	КПОН	Муниципальный аэропорт Покахонтас	Покахонтас , Айова , США		
POI	СЛПО	Аэропорт капитана Николаса Рохаса [1]	Потоси , Боливия		
ПОЖ	СНПД	Аэропорт Педро Перейра душ Сантуш	Патос-де-Минас , Минас-Жерайс , Бразилия		
ПОЛ	FQPB	Пемба аэропорт	Пемба , Мозамбик		
ПОМ	АЙПИ	Международный аэропорт Джексонс	Порт-Морсби , Папуа-Новая Гвинея		
PON	МГПП	Аэропорт Поптун [1]	Поптун , Гватемала		
ПОО	СБПК	Аэропорт Посус-де-Калдас [1]	Посуш-де-Калдас , Минас-Жерайс , Бразилия		
ПОП	МДПП	Международный аэропорт Грегорио Луперон	Сан-Фелипе-де-Пуэрто-Плата , Доминиканская Республика		
ПОР	ЕФПО	Аэропорт Пори	Пори , Финляндия		
POS-терминал	ТТПП	Международный аэропорт Пиарко	Порт-оф-Спейн , Тринидад и Тобаго		
ГОРШОК	МККДЖ	Кен Джонс Аэродром	Порт-Антонио , Ямайка		
ПОУ	КПОУ	Аэропорт округа Датчесс	Покипси , Нью-Йорк , США		
ПОВ	ЛЗПВ	Авиабаза Прешов [1]	Прешов , Словакия		
военнопленный	ЛДЖПЗ	Порторож аэропорт	Порторож , Словения		
ПОКС	ЛФПТ	Понтуаз – Аэродром Кормей	Париж , Иль-де-Франс , Франция		
ПОЯ	КПОИ	Муниципальный аэропорт Пауэлл	Пауэлл / Ловелл , Вайоминг , США		
ПОЗ	ЕОКЗР	Аэропорт Познань-Лавица	Познань , Польша		
ППА	КППА	Перри Лефорс Филд	Пампа , Техас , США		
ППБ	СБДН	Аэропорт Президенти-Пруденти	Президенти-Пруденти , Сан-Паулу , Бразилия		
КПП	ПАПР	Проспект Крик аэропорт	Проспект-Крик , Аляска , США		
СИЗ	ММПЭ	Международный аэропорт Пуэрто-Пеньяско	Пуэрто-Пеньяско , Сонора , Мексика		
ППФ	КППФ	Аэропорт Три-Сити	Парсонс , Канзас , США		
ППГ	НГТУ	Международный аэропорт Паго-Паго	Паго-Паго , Американское Самоа		
ППГ		Аэропорт Параи-тепуи [1]	Параи-тепуи (Пераитепуй), Венесуэла		
ИЦП	ЮПИР	Аэропорт Порт-Пири	Порт-Пири , Южная Австралия , Австралия		
ППЖ	КВИГ	Аэропорт острова Панджанг [1]	Остров Панджанг , Индонезия		
ППК	UACP	Петропавловский аэропорт	Петропавловск (Петропавловск), Казахстан		
ЗГЗ	ВНПЛ	Аэропорт Пхаплу	Пхафлу , Непал		
ППМ	КПМП	Аэропорт Помпано-Бич (FAA: PMP)	Помпано-Бич , Флорида , США		
ППН	СКПП	Гильермо Леон Валенсия аэропорт	Попаян , Колумбия		
ГЧП	ЯБПН	Аэропорт Уитсанди Кост	Прозерпина , Квинсленд , Австралия		
PPQ	НЗПП	Аэропорт Капити Кост	Пляж Парапарауму , Новая Зеландия		
ППР	ШИРОКИЙ	Аэропорт Туанку Тамбусай [1]	Пасир Пангараян (Pasir Pangarayan), Индонезия		
ППС	РПВП	Международный аэропорт Пуэрто-Принсеса	Пуэрто-Принсеса , Филиппины		
ППТ	НТАА	Международный аэропорт Фааа	Папеэте , Таити , Французская Полинезия		
ППУ	ВЫПП	Аэропорт Папун [1]	Папун , Мьянма		
ППВ		База гидросамолетов защиты порта (FAA: 19P)	Порт Протекшн , Аляска , США		
ППВ	ЕГЭП	Папа Вестрей: аэропорт	Папа Вестрей , Шотландия , Великобритания		
ППХ		Аэропорт Парам [1]	Парам , Папуа-Новая Гвинея		
ППЙ	СНЗА	Аэропорт Посу-Алегри [1]	Позу-Алегри , Минас-Жерайс , Бразилия		
ППЗ		Аэропорт Пуэрто Паес [1]	Пуэрто Паес , Венесуэла		
ПКК	ВВПК	Международный аэропорт Фукуока	Остров Фукуок , Вьетнам		
ПКД		База гидросамолетов Баттикалоа [1]	Баттикалоа , Шри-Ланка		
ПКИ	КПКИ	Региональный аэропорт Северного Мэна на Преск-Айле	Преск-Айл , Мэн , США		
ПКМ	ММПК	Международный аэропорт Паленке [1]	Паленке , Чьяпас , Мексика		
ПКК	ЯПМК	Порт-Маккуори: аэропорт	Порт-Маккуори , Новый Южный Уэльс , Австралия		
PQS		Пилотная станция аэропорта (FAA: 0AK)	Пилотная станция , Аляска , США		
ПРА	СААП	Аэропорт имени генерала Хусто Хосе де Уркиса	Парана , Энтре-Риос , Аргентина		
ПРБ	КПРБ	Муниципальный аэропорт Пасо Роблес	Пасо Роблес , Калифорния , США		
КНР	КНДР	Эрнест А. Лав Филд	Прескотт , Аризона , США		
ПРД	ЮПДО	Аэропорт Парду [1]	Станция Парду , Западная Австралия , Австралия		
ПРЕДВАРИТЕЛЬНО		Аэропорт Поре [1]	Поре , Колумбия		
ЭРГ	ЛКПР	Аэропорт Вацлава Гавела Прага	Прага , Чехия		
ПРХ	ВЦП	Аэропорт Пхрэ	Пхрае , Таиланд		
ПРИ	ФСПП	Аэропорт острова Праслен	Остров Праслен , Сейшельские острова		
ФРК	ФАПК	Аэропорт Приска [1]	Приска , Южная Африка		
ФРМ	ЛПММ	Портиман аэропорт	Портиман , Португалия		
ПРН	БКПР	Международный аэропорт Приштины Адем Джашари	Приштина , Косово		
ПРО	КПРО	Муниципальный аэропорт Перри	Перри , Айова , США		
ПРП	ЛФКО	Проприано аэропорт	Проприано , Корсика , Франция		
PRQ	ОРВИ	Президентский аэропорт Роке Саенс Пенья	Президиум Роке Саенс Пенья , Чако , Аргентина		
ПРР	СИПР	Аэропорт Паруйма	Паруима , Гайана		
ПРС	АГГП	Аэропорт Параси [1]	Параси , Соломоновы Острова		
ПРУ	ВЫПЫ	Аэропорт Пай [1]	Пьяй (Пром), Мьянма		
ПРВ	ЛКПО	Аэропорт Пршеров [1]	Пршеров , Чехия		
PRW		Аэропорт Прентис (FAA: 5N2)	Прентис , Висконсин , США		
PRX	КПРХ	Кокс Филд	Париж , Техас , США		
ПРАЙ	ФАВБ	Вандербум аэропорт	Претория , Южная Африка		
ПРЗ		Аэропорт Прайнвилля (FAA: S39)	Прайнвилл , Орегон , США		
СРП	ЛИРП	Международный аэропорт Пизы (аэропорт Галилео Галилей)	Пиза , Тоскана , Италия		
Промсвязьбанк	КПСБ	Региональный аэропорт Среднего штата	Раш (тауншип, округ Центр , Пенсильвания , США)		
PSC	КПСК	Аэропорт Три-Ситис	Паско , Вашингтон , США		
PSD	ГЭС	Аэропорт Порт-Саид [1]	Порт-Саид , Египет		
PSE	ТЖПС	Аэропорт Мерседита	Понсе , Пуэрто-Рико		
ПСФ	КПСФ	Муниципальный аэропорт Питтсфилда	Питтсфилд , Массачусетс , США		
ПСЖ	ПАПГ	Петербургский аэропорт Джеймса А. Джонсона	Петербург , Аляска , США		
ПШ	ЭДХО	Аэропорт Санкт-Петер-Ординг [1]	Санкт-Петер-Ординг , земля Шлезвиг-Гольштейн , Германия		
пси	ОППИ	Аэропорт Пасни [1]	Пасни , Пакистан		
ПСЖ	ВАМП	Касигунджу аэропорт [1]	Посо , Индонезия		
ПСК	КПСК	Аэропорт Нью-Ривер-Вэлли	Дублин , Вирджиния , США		
ПСЛ	Египет	Аэропорт Перта (аэропорт Скоун)	Перт , Шотландия , Великобритания		
ПСМ	КПСМ	Международный аэропорт Портсмута в Пиз	Портсмут , Нью-Гэмпшир , США		
ПСН	КПСН	Муниципальный аэропорт Палестины	Палестина , Техас , США		
ПСО	СКПС	Антонио Нариньо аэропорт	Пасто , Колумбия		
ПСП	КПСП	Международный аэропорт Палм-Спрингс	Палм-Спрингс , Калифорния , США		
PSQ		База гидросамолетов в Филадельфии (FAA: 9N2)	Филадельфия , Пенсильвания , США		
ПСР	ЛИБП	Абруццо аэропорт	Пескара , Абруццо , Италия		
ПСС	САРП	Аэропорт Генерала-Либертадора Хосе де Сан-Мартин	Посадас , Мисьонес , Аргентина		
блок питания	НВОП	Аэропорт Пангсума [1]	Путуссибау , Индонезия		
ПСВ		Взлетно-посадочная полоса Папа-Стор [1]	Папа Стоур , Шотландия , Великобритания		
ПСВ	СНОС	Аэропорт Пассос [1]	Пассос , Минас-Жерайс , Бразилия		
PSX	КПССХ	Муниципальный аэропорт Паласиос	Паласиос , Техас , США		
PSY	СФАЛ	Порт Стэнли аэропорт	Стэнли , Британская заморская территория Фолклендские острова		
ПСЗ	СЛПС	Международный аэропорт Пуэрто Суарес	Пуэрто Суарес , Боливия		
ПТА	ПАЛЖ	Аэропорт Порт-Олсуорт (FAA: TPO)	Порт-Олсворт , Аляска , США		
ПТБ	КПТБ	Аэропорт округа Динвидди	Петербург , Вирджиния , США		
ПТК		База гидросамолетов Порт-Алисы (FAA: 16K)	Порт-Алиса , Аляска , США		
ПТД	ПААП	База гидросамолетов Порт-Александр (FAA: AHP)	Порт-Александер , Аляска , США		
ПТФ	НФФО	Аэропорт Малоло Лайлай [1]	Малоло Лайлай , Фиджи		
ПТГ	ФАПП	Международный аэропорт Полокване	Полокване , Южная Африка		
ПТХ	ЛАГН	Порт-Хейден: аэропорт	Порт-Хейден , Аляска , США		
ПТЖ	ЮПОД	Портленд аэропорт	Портленд , Виктория , Австралия		
ПТК	КПТК	Международный аэропорт округа Окленд	Понтиак , Мичиган , США		
ПТМ	СВПТ	Аэропорт Пальмарито [1]	Пальмарито , Венесуэла		
ПТН	КПТН	Мемориальный аэропорт Гарри П. Уильямса	Паттерсон , Луизиана , США		
ВОМ	ССПБ	Аэропорт Жувеналь Лурейру Кардозу [1]	Пато-Бранко , Парана , Бразилия		
ПТП	СФФР	Международный аэропорт Пуэнт-а-Питр (аэропорт Ле Рэзе)	Пуэнт-а-Питр , Гваделупа		
ПТК	СНМЗ	Аэропорт Порту-де-Мос [1]	Порту-де-Мос , Пара , Бразилия		
ПТС	КПТС	Муниципальный аэропорт Аткинсон	Питтсбург , Канзас , США		
РТТ	КПТТ	Региональный аэропорт Пратт	Пратт , Канзас , США		
ПТУ	ПАРМ	Платиновый аэропорт	Платинум , Аляска , США		
ПТВ	КПТВ	Муниципальный аэропорт Портервилля	Портервилл , Калифорния , США		
ПТВ	КПТВ	Поле наследия	Поттстаун , Пенсильвания , США		
ПТХ	СКПИ	Аэропорт Контадор [1]	Питалито , Колумбия		
ПТИ	МПТО	Международный аэропорт Токумен	Панама-Сити , Панама		
ПТЗ	СЕПА	Аэропорт Рио-Амазонас	Шелл , Эквадор		
ПУА		Аэропорт Пуас [1]	Пуас , Папуа-Новая Гвинея		
ПАБ	КПУБ	Мемориальный аэропорт Пуэбло	Пуэбло , Колорадо , США		
ПУК	КПУК	Региональный аэропорт округа Карбон	Прайс , Юта , США		
ПУД	ПИЛА	Аэропорт Пуэрто Десеадо	Пуэрто-Десеадо , Санта-Крус , Аргентина		
ПУЭ	МПОА	Аэропорт Пуэрто-Обалдия [1]	Пуэрто-Обальдия , Панама		
ППУ	ЛФБП	Аэропорт По-Пиренеи	По , Аквитания , Франция		
МОПС	YPAG	Аэропорт Порт-Огаста [1]	Порт-Огаста , Южная Австралия , Австралия		
ПУИ		Аэропорт Пурени	Пурени , Папуа-Новая Гвинея		
ПЯЖ	МДПК	Международный аэропорт Пунта-Кана	Пунта Кана , Доминиканская Республика		
ПУК	НТГК	Пукаруа аэропорт	Пукаруа , Туамотус , Французская Полинезия		
ПУЛ		База гидросамолетов в порту Пулсбо (FAA: 83Q)	Поулсбо , Вашингтон , США		
каламбур	ФЗОП	Аэропорт Пуния [1]	Пуния , Демократическая Республика Конго		
щенок	ДФКП	Аэропорт По	По , Буркина-Фасо		
ПКК	SCCI	Международный аэропорт Президенте Карлоса Ибаньеса дель Кампо	Пунта-Аренас , Чили		
ПУР	СЛПР	Аэропорт Пуэрто-Рико [1]	Пуэрто-Рико , Боливия		
ГНОЙ	РКПК	Международный аэропорт Кимхэ	Пусан , Южная Корея		
ПОМЕЩАТЬ	ВОПН	Аэропорт Шри Сатья Саи [1]	Путтапарти , Андхра-Прадеш , Индия		
ОПУ	СКАС	Аэропорт Трес де Майо	Пуэрто-Асис , Колумбия		
ПУВ	СЗПП	Аэропорт Малабу [1]	Пум , Новая Каледония		
ПУВ	КПУВ	Пуллман – Московский региональный аэропорт	Пулман / Москва (ID) , Вашингтон , США		
ПУКС	SCPV	Аэропорт Эль-Мирадор [1]	Пуэрто-Варас , Чили		
ПУЙ	ЛДПЛ	Аэропорт Пула	Пула , Хорватия		
ПУЗ	МНПК	Аэропорт Пуэрто Кабесас	Пуэрто Кабесас , Никарагуа		
ПВА	СКПВ	Эль Эмбрухо аэропорт	Остров Провиденсия , Колумбия		
ПВХ	КПВХ	Муниципальный аэропорт Провинстаун	Провинстаун , Массачусетс , США		
ПВД	КПВД	Аэропорт штата Теодор Фрэнсис Грин	Провиденс , Род-Айленд , США		
ПВЕ	МПВР	Аэропорт Эль-Порвенир [1]	Эль-Порвенир , Панама		
ПВФ	КПВФ	Аэропорт Плейсервилл	Плейсервилл , Калифорния , США		
ПВГ	ЗСПД	Международный аэропорт Шанхай Пудун	Шанхай , Китай		
ПВХ	СБПВ	Международный аэропорт губернатора Хорхе Тейшейра де Оливейра	Порту-Велью , Рондония , Бразилия		
ПВИ	ССПИ	Аэропорт Эду Чавес [1]	Паранаваи , Парана , Бразилия		
ПВК	ЛГПЗ	Национальный аэропорт Актион	Превеза / Лефкас , Греция		
ПВЛ	КПБКС	Аэропорт округа Пайк [1] ​​(FAA: PBX)	Пайквилл , Кентукки , США		
ПВО	СЭПВ	Аэропорт Реалес Тамариндос	Портовьехо , Эквадор		
ПВР	ММПР	Международный аэропорт Лиценсиадо Густаво Диас Ордас	Пуэрто-Вальярта , Халиско , Мексика		
ПВС	УГМД	Аэропорт Провидения Бэй	Провидения , Чукотка , Россия		
ПВУ	КПВУ	Муниципальный аэропорт Прово	Прово , Юта , США		
ПВВ	КПВВ	Аэропорт округа Хейл	Плейнвью , Техас , США		
ПВА	КПВА	Аэропорт Уайли Пост	Оклахома-Сити , Оклахома , США		
ЛЮДИ	КПВД	Шер-Вуд аэропорт	Плентивуд , Монтана , США		
ПВЕ	УХМП	Певек аэропорт	Певек , Чукотка , Россия		
ПВИ		Аэропорт Белес [1]	Пави , Эфиопия		
ПВК	КПВК	Представительский аэропорт Чикаго	Чикаго , Иллинойс , США		
ПВЛ	WICP	Аэропорт Вирасаба	Пурвокерто , Индонезия		
ШИМ	КПВМ	Портлендский международный реактивный порт	Портленд , Мэн , США		
PWN	MYCP	Аэропорт Питтс-Таун [1]	Питтс-Таун , Крукед-Айленд , Багамские острова		
ПВО	ФЗКК	Аэропорт Пвето [1]	Пвето , Демократическая Республика Конго		
PWQ	УАСП	Павлодар аэропорт	Павлодар , Казахстан		
PWR		База гидросамолетов Порт-Уолтер [1]	Порт-Уолтер , Аляска , США		
ПВТ	КПВТ	Национальный аэропорт Бремертона	Бремертон , Вашингтон , США		
PWY	КПНА	Ральф Венц Филд (ФАУ: ПНА)	Пайндейл , Вайоминг , США		
ПХА	ВИПИ	Аэропорт Атунг Бунгсу [1]	Пагар Алам , Южная Суматра , Индонезия		
ПХХ	ЯПМХ	Аэропорт Проминент-Хилл [1]	Проминент-Хилл , Южная Австралия , Австралия		
ПХЛ		Аэропорт Полакка (FAA: P10)	Полакка , Аризона , США		
ПХМ	ММПС	Международный аэропорт Пуэрто-Эскондидо	Пуэрто-Эскондидо , Оахака , Мексика		
ПХО	ЛППС	Порто Санто аэропорт	Остров Порту-Санту , Мадейра , Португалия		
PXR	ВТУЖ	Аэропорт Сурин [1]	Сурин , Таиланд		
ПХУ	ВВПК	Плейку аэропорт	Плейку , Вьетнам		
ПЯ	СКВЛ	Аэропорт Веласкес [1]	Пуэрто Бояка , Колумбия		
ПИБ	ВЭЙП	Аэропорт Джейпур [1]	Джейпур , Одиша , Индия		
ПКС		Аэропорт Плайон-Чико	Укупсени (Плайон-Чико), Панама		
ПАЙ	НКПЮ	Аэропорт Тонгарева [1]	Атолл Пенрин , Острова Кука		
ПГГ		Аэропорт Пакьонг	Пакьонг , Сикким , Индия		
ПЮХ	СВПА	Касике Арамаре аэропорт	Пуэрто-Аякучо , Венесуэла		
ПИЖ	ЕПРП	Аэропорт Полярный	Полярный , Якутия , Россия.		
ПЮК	ОИИП	Международный аэропорт Паям [1]	Карадж , Иран		
ПИЛ		База гидросамолетов на острове Перри [1]	Перри-Айленд , Аляска , США		
ПИМ	КПИМ	Муниципальный аэропорт Плимута	Плимут , Массачусетс , США		
ПИН		Аэропорт Паян [1]	Паян , Колумбия		
ПИО	СЕНТЯБРЬ	Аэропорт Путумайо [1]	Пуэрто-эль-Кармен-де-Путумайо , Эквадор		
ПИР	ЛГАД	Авиабаза Андравида [1]	Пиргос , Греция		
ПИС		Парадайз Скайпарк [1] ​​(FAA: CA92)	Парадайз , Калифорния , США		
ПИВ		Аэропорт Явиза [1]	Явиза , Панама		
ПГГ		Аэропорт Пай	Пай , Таиланд		
ПЗА	СКПЗ	Аэропорт Пас-де-Арипоро [1]	Пас де Арипоро , Колумбия		
ПЗБ	ФАПМ	Аэропорт Питермарицбург	Питермарицбург , Южная Африка		
ПЖ	ОПЗБ	Аэропорт Жоб	Жоб , Пакистан		
ПЗИ	ЗУЖ	Аэропорт Паньчжихуа Баоаньин [1]	Паньчжихуа , Сычуань , Китай		
ПЗК	НКПК	Аэродром острова Пукапука [1]	Остров Пукапука , Острова Кука		
ПЗЛ	Часто задаваемые вопросы	Аэропорт Зулу Иньяла [1]	Финда , Южная Африка		
ПЗО	СВПР	Мануэль Карлос Пиар Аэропорт Гуаяна	Сьюдад-Гуаяна / Пуэрто-Ордас , Венесуэла		
ПЗС	СКТС	Аэропорт Макеуэ [1]	Темуко , Чили		
ПЗУ	HSPN	Новый международный аэропорт Порт-Судана	Порт-Судан , Судан		
ПЗЫ	ЛЗПП	Аэропорт Пиешт