ЫПА	Аэропорт Хпа-Ан [1]	Хпа-Ан , Мьянма		
ЕБУ	Биласпур аэропорт	Биласпур , Чхаттисгарх , Индия		
ПМГ	Международный аэропорт Альбрук «Маркос А. Гелаберт»	Панама-Сити , Панама		
ДЛП	Падерборн Липпштадт аэропорт	Падерборн / Липпштадт , Северный Рейн-Вестфалия , Германия		
ПАЭ	Пейн Филд (аэропорт округа Снохомиш)	Эверетт , Вашингтон , США		
УПА	Аэродром Пакуба	Пакуба , Уганда		
ПМП	Пагадиан аэропорт	Пагадиан , Филиппины		
ПАХ	Региональный аэропорт Баркли	Падука , Кентукки , США		
ППК	Аэропорт Парачинар [1]	Парачинар , Пакистан		
HPA	Порт Аллен: аэропорт	Ханапепе , Гавайи , США		
КПК	Авиабаза капитана Хермана Олано Морено [1]	Паланкеро , Колумбия		
ПАМ	База ВВС Тиндалл	Панама-Сити , Флорида , США		
ЮЛЯ	ВТСК	Аэропорт Паттани	Паттани , Таиланд		
ПАО	Аэропорт Пало-Альто (аэропорт округа Санта-Клара)	Пало-Альто , Калифорния , США		
ТПП	Международный аэропорт Туссен-Лувертюр	Порт-о-Пренс , Гаити		
ААК	Муниципальный аэропорт Палмер	Палмер , Аляска , США		
1]		агломерация 1	Париж , Иль-де-Франс , Франция		
GPA	Национальный аэропорт Пароса	Парос , Греция		
ЭПТ	Аэропорт Лок Наяк Джаяпракаш	Патна , Бихар , Индия		
ЫПК	Аэропорт Паук [1]	Паук , Мьянма		
БУФ	Аэропорт Паулу Афонсу [1]	Паулу Афонсу , Баия , Бразилия		
	Аэропорт Памбва [1]	Памбва , Папуа-Новая Гвинея		
МТРХ	Аэропорт Порт-де-Пе [1]	Порт-де-Пе , Гаити		
ТЬ	ВБКП	Аэропорт Памол [1]	Памол , Сабах , Малайзия		
МПА	Национальный аэропорт Эль-Тахин	Поса-Рика , Веракрус , Мексика		
СПН	Аэропорт Паранаиба [1]	Паранаиба , Мату-Гросу-ду-Сул , Бразилия		
ный банк Китая	ММПБ	Международный аэропорт Херманос Сердан	Пуэбла , Пуэбла , Мексика		
АПР	Аэропорт Порбандар [1]	Порбандар , Гуджарат , Индия		
КПР	Аэропорт Морела [1] (аэропорт Пуэрто Беррио)	Пуэрто Беррио , Колумбия		
ПБФ	Грайдер Филд	Пайн-Блафф , Арканзас , США		
ПБГ	Международный аэропорт Платтсбург	Платтсбург , Нью-Йорк , США		
КПР	Международный аэропорт Паро	Паро , Бутан		
ПБИ	Международный аэропорт Палм-Бич	Уэст-Палм-Бич , Флорида , США		
ВСИ	Аэропорт Паама [1]	Паама , Вануату		
ВПК	Аэропорт Бартоломе Салом [1]	Пуэрто-Кабельо , Венесуэла		
МДЖП	Международный аэропорт Йохан Адольф Пенгель	Парамарибо , Суринам		
НПА	Аэропорт Порту-Амбоим [1]	Порту-Амбоим , Ангола		
ПБО	Аэропорт Парабурду	Парабурду , Западная Австралия , Австралия		
РТ	Аэропорт Пунта Ислита	Пунта-Ислита , Коста-Рика		
WPM	Аэропорт Пимента Буэно [1]	Пимента Буэно , Рондония , Бразилия		
ГПБ	Аэропорт Пуэрто-Барриос [1]	Пуэрто-Барриос , Гватемала		
Аэропорт Пуэрто-Леда [1]	Пуэрто-Леда , Парагвай		
ЫПТ	Аэропорт Путао [1]	Путао , Мьянма		
ВПГ	Аэропорт Порту-дус-Гаушос	Порту-дус-Гаушос , Мату-Гросу , Бразилия		
ВПК	Аэропорт Фазенда Пирагуасу	Порту-Алегри-ду-Норти , Мату-Гросу , Бразилия		
АПГ	Аэропорт Плеттенберг Бэй [1]	Плеттенберг Бэй , Южная Африка		
АОК	Аэропорт Портидж-Крик (FAA: A14)	Портидж-Крик , Аляска , США		
ная плата	ВИХП	Аэропорт Пондок-Кабе [1]	Южный Тангеранг , Индонезия		
Аэропорт Пуэрто-Рико [1]	Пуэрто-Рико , Колумбия		
ПДК	Муниципальный аэропорт Прейри-дю-Шен (FAA: PDC)	Прейри-дю-Чьен , Висконсин , США		
АПС	Аэропорт Почефструм [1]	Почефструм , Южная Африка		
ПК	Аэропорт Паласиос [1]	Паласиос , Гондурас		
Аэропорт Пуэрто-ла-Виктория [1]	Пуэрто-Касадо (Ла-Виктория), Парагвай		
ПЛК	Международный аэропорт имени капитана ФАП Давида Абенсура Ренхифо	Пукальпа , Перу		
Аэропорт Плая дель Кармен	Плайя-дель-Кармен , Кинтана-Роо , Мексика		
ЗОК	Аэродром Пиктон	Пиктон , Новая Зеландия		
МПЛ	Взлетно-посадочная полоса Пунта-Колорада [1]	Ла-Рибера , Южная Нижняя Калифорния , Мексика		
ППР	Аэропорт Принсипи [1]	Остров Принсипи , Сан-Томе и Принсипи		
Аэропорт Бун Неуа [1]	Фонгсали , Лаос		
КПК	Аэропорт Херман Олано	Пуэрто Карреньо , Колумбия		
НПК	Аэропорт Пикос [1]	Пикос , Пиауи , Бразилия		
Аэропорт Принстон (FAA: 39N)	Принстон / Роки-Хилл , Нью-Джерси , США		
Аэропорт Поплвилл-Перл-Ривер [1] (FAA: M13)	Попларвилл , Миссисипи , США		
Взлетно-посадочная полоса Пунта Чивато [1]	Пунта Чивато , Южная Нижняя Калифорния , Мексика		
КПД	Аэропорт Обандо	Пуэрто-Инирида , Колумбия		
Аэропорт Педро Бэй (FAA: 4K0)	Педро Бэй , Аляска , США		
ЗВК	Муэо/Никель аэропорт	Муэо , Новая Каледония		
QPO	Аэропорт Понта-ду-Ору [1]	Понта-ду-Ору , Мозамбик		
ПДИ	Аэропорт Панди Панди [1]	Станция Панди Панди , Южная Австралия , Австралия		
ИАЖ	Аэропорт Фаз Тауа [1]	Прадо , Баия , Бразилия		
ИПТ	Международный аэропорт Минангкабау	Паданг , Индонезия		
Аэропорт Пинду [1]	Пиндиу , Папуа-Новая Гвинея		
ПДК	Аэропорт ДеКалб – Пичтри	Атланта , Джорджия , США		
ППД	Аэропорт Жуан Паулу II	Понта-Делгада , Азорские острова , Португалия		
Аэропорт Педаси [1] (Аэропорт капитана Дж. Монтенегро)	Педаси , Панама		
Аэропорт Парндана [1]	Парндана , Южная Австралия , Австралия		
IPQ	Аэропорт Пендопо [1]	Пендопо , Индонезия		
УЛС	Международный аэропорт Капитан де Корбета Карлос А. Курбело	Пунта-дель-Эсте , Уругвай		
Аэропорт Президенти Дутра [1]	Президенти Дутра , Мараньян , Бразилия		
МПГ	Международный аэропорт Пьедрас Неграс	Пьедрас-Неграс , Коауила , Мексика		
кеанское летнее время	КПДТ	Региональный аэропорт Восточного Орегона	Пендлтон , Орегон , США		
УПУ	Международный аэропорт Тайдео Ларре Борхес	Пайсанду , Уругвай		
БПД	Аэропорт Пловдив	Пловдив , Болгария		
КПДКС	Международный аэропорт Портленда	Портленд , Орегон , США		
ВПЭ	Аэропорт Педерналес [1]	Педерналес , Венесуэла		
ПШ	Аэропорт Пеннешоу [1]	Пеннешоу , Южная Австралия , Австралия		
Аэропорт Пебане [1]	Пебане , Мозамбик		
База гидросамолетов «Пеликан» [1]	Пеликан , Аляска , США		
КПД	Аэропорт Пардубице	Пардубице , Чехия		
СПП	Международный аэропорт Пермь (Аэропорт Большое Савино)	Пермь , Пермский край , Россия		
ДКП	Аэродром Пенемюнде [1]	Пенемюнде , Мекленбург-Передняя Померания , Германия		
ИРЗ	Перуджа Сан-Франческо д'Ассизи – международный аэропорт Умбрии	Перуджа , Умбрия , Италия		
АЗП	Комодоро Педро Занни: аэропорт	Пеуахо , Буэнос-Айрес , Аргентина		
КПЭ	Международный аэропорт Матеканья	Перейра , Колумбия		
БАА	Международный аэропорт Пекин Столичный	Пекин , Китай		
XPG	Аэропорт Пеланенг [1]	Пеланенг , Лесото		
ПТУ	Международный аэропорт Падре Альдамис	Пуэрто Мальдонадо , Перу		
	ВМКП	Международный аэропорт Пенанга	Пенанг , Малайзия		
Аэропорт Пеппименарти [1]	Пеппименарти , Северная территория , Австралия		
ПЭК	Муниципальный аэропорт Пекос	Пекос , Техас , США		
ППХ	Перт аэропорт	Перт , Западная Австралия , Австралия		
ЛПБ	Аэропорт Петрозаводска (Аэропорт Бесовец)	Петрозаводск , Карелия , Россия.		
НИЙ ПИТОМЕЦ	СБПК	Международный аэропорт Жоау Симойнс Лопес Нето	Пелотас , Риу-Гранди-ду-Сул , Бразилия		
ХПЛ	Аэропорт Пуэрто Лемпира [1]	Пуэрто Лемпира , Гондурас		
ТЭ	Международный аэропорт Печ-Погань [1]	Печ , Венгрия		
ППС	Международный аэропорт Бача Хан	Пешавар , Пакистан		
УУЙП	Аэропорт Печора	Печора , Республика Коми , Россия		
Аэропорт Пенонг [1]	Пенонг , Южная Австралия , Австралия		
ВЭС	Аэропорт Пензы (Аэропорт Терновка)	Пенза , Пензенская область , Россия		
БПФ	Аэропорт Лауро Курц	Пассо Фундо , Риу-Гранди-ду-Сул , Бразилия		
ПФК	Государственный аэропорт Пасифик-Сити	Пасифик-Сити , Орегон , США		
ИПА	Аэропорт Патрексфьордюр	Патрексфьордур , Исландия		
Аэродром Примроуз	Вуд Буффало , Альберта , Канада		
CPH	Международный аэропорт Пафоса	Пафос , Кипр		
ИТП	Аэропорт Парсабад-Моган [1]	Парсабад , Иран		
ЗВС	Аэропорт Илебо [1]	Илебо , Демократическая Республика Конго		
ПГА	Муниципальный аэропорт Пейдж	Пейдж , Аризона , США		
Аэропорт Пангоа [1]	Пангоа , Папуа-Новая Гвинея		
Аэропорт округа Грант (FAA: W99)	Петербург , Западная Вирджиния , США		
ПГД	Аэропорт Пунта Горда	Пунта Горда , Флорида , США		
Йегепа аэропорт	Йегепа , Папуа-Новая Гвинея		
ФМП	Аэропорт Перпиньян-Ривесальт	Перпиньян , Лангедок-Руссильон , Франция		
ИПТ	Аэропорт Пантнагар [1]	Пантнагар , Уттаракханд , Индия		
НЧ	Аэропорт Читато [1]	Читато , Ангола		
ИПК	Аэропорт Депати Амир [1]	Пангкал Пинанг (Пангкалпинанг), Индонезия		
ПКЛ	Международный аэропорт Трент Лотт (FAA: PQL)	Паскагула , Миссисипи , США		
Аэропорт Порт-Грэм	Порт-Грэм , Аляска , США		
Аэропорт Пангиа [1]	Пангиа , Папуа-Новая Гвинея		
ПСО	Стивенс Филд (ФАУ: PSO)	Пагоса-Спрингс , Колорадо , США		
ЭМ	Аэропорт Були	Були , Северное Малуку , Индонезия		
ПГР	Кирк Филд	Парагулд , Арканзас , США		
Аэропорт Гранд-Каньон-Кавернс (FAA: L37)	Пич-Спрингс , Аризона , США		
ИБП	Аэропорт Персидского залива [1]	Асалуе (Асалойе), Иран		
ПГВ	Аэропорт Питт-Гринвилл	Гринвилл , Северная Каролина , США		
ФБКС	Аэропорт Перигё-Бассийяк	Перигё , Аквитания , Франция		
СЗВ	Граф. Аэропорт Антонио Амилтон Беральдо [1]	Понта-Гросса , Парана , Бразилия		
ВПР	Авиабаза Фан Ранг [1]	Фан Ранг – Тхап Чам , Вьетнам		
БПБ	Международный аэропорт Парнаиба-Префейто имени доктора Жоау Силва Фильо	Парнаиба , Пиауи , Бразилия		
ДНПО	Международный аэропорт Порт-Харкорт	Порт-Харкорт , Нигерия		
ДАТ НАУК	КПХД	Гарри Клевер Филд	Нью-Филадельфия , Огайо , США		
PPD	Международный аэропорт Порт-Хедленд	Порт-Хедленд , Западная Австралия , Австралия		
ПХФ	Ньюпорт-Ньюс / Международный аэропорт Уильямсбург	Ньюпорт-Ньюс / Вильямсбург , Вирджиния , США		
Аэропорт Порт-Харкорт-Сити [1]	Порт-Харкорт , Нигерия		
ЙЕ	Аэропорт Пиньейру [1]	Пиньейру , Мараньян , Бразилия		
ПХК	Аэропорт Палм-Бич Каунти-Глэйдс	Пахоки , Флорида , США		
ПХЛ	Международный аэропорт Филадельфии	Филадельфия , Пенсильвания , США		
ПХН	Международный аэропорт округа Сент-Клер	Порт-Гурон , Мичиган , США		
ПО	Аэропорт Пойнт Хоуп	Пойнт-Хоуп , Аляска , США		
ПХП	Аэропорт Филип	Филип , Южная Дакота , США		
квартира	ЮТМО	Аэропорт Монумент [1]	Фосфат-Хилл , Квинсленд , Австралия		
ФНД	Аэропорт Пасифик-Харбор [1]	Пасифик-Харбор , Фиджи		
ТПП	Пхитсанулок аэропорт	Пхитсанулок , Таиланд		
ПХТ	Аэропорт Генри Каунти	Пэрис , Теннесси , США		
АПГ	Аэропорт Хендрик Ван Эк	Пхалаборва , Южная Африка		
ПХХ	Международный аэропорт Финикс Скай Харбор	Финикс , Аризона , США		
ЕСКИЙ	ВТПБ	Пхетчабун аэропорт	Пхетчабун , Таиланд		
ПИА	Международный аэропорт имени генерала Уэйна А. Даунинга в Пеории	Пеория , Иллинойс , США		
ПИБ	Региональный аэропорт Хаттисберг-Лорел	Хаттисберг / Лорел , Миссисипи , США		
BPI	Аэропорт Пайн-Кей [1]	Пайн-Кей , Британская заморская территория островов Тёркс и Кайкос		
	КПИЕ	Международный аэропорт Сент-Пит-Клируотер	Санкт-Петербург / Клируотер , США		
ЦДЦ [2]	Южный аэропорт Пиндун [1]	Город Пиндун , Тайвань		
ПИХ	Региональный аэропорт Покателло	Покателло , Айдахо , США		
ГПК	Глазго Прествик аэропорт	Глазго , Шотландия , Великобритания		
ГПИ	Аэропорт Карлос Мигель Хименес	Пилар , Парагвай		
ПИМ	Аэропорт Харрис Каунти	Пайн-Маунтин , Джорджия , США		
ЛОТЬ	SWPI	Аэропорт Жулио Белен	Паринтинс , Амазонас , Бразилия		
ПСО	Капитан ФАП Ренан Элиас Оливера Аэропорт	Писко , Перу		
АПН	Аэропорт Пилот-Пойнт (FAA: PNP)	Пилот-Пойнт , Аляска , США		
Аэропорт Пипиллипай [1]	Пипиллипай , Гайана		
ПИР	Региональный аэропорт Пьер	Пьер , Южная Дакота , США		
ФБИ	Аэропорт Пуатье-Биар	Пуатье , Пуату-Шаранта , Франция		
ПИТ	Международный аэропорт Питтсбурга	Питтсбург , Пенсильвания , США		
ПОРА	Международный аэропорт имени капитана ФАП Гильермо Конча Иберико	Пьюра , Перу		
НПКС	Аэропорт Пирапора [1]	Пирапора , Минас-Жерайс , Бразилия		
ЗМН	Аэропорт Пиквитоней [1]	Пиквитоней , Манитоба , Канада		
ЛППИ	Аэропорт Пико	Остров Пику , Азорские острова , Португалия		
ПИЗ	Аэропорт Пойнт-Лэй LRRS	Пойнт-Лэй , Аляска , США		
ей-
СУП	Пайала аэропорт	Пайала , Швеция		
КПАН	Аэропорт Пейсон (FAA: PAN)	Пейсон , Аризона , США		
ГПЖ	Международный аэропорт имени доктора Аугусто Роберто Фустера	Педро Хуан Кабальеро , Парагвай		
ОППГ	Аэропорт Панджгур	Панджгур , Пакистан		
МРПЖ	Аэропорт Пуэрто-Хименес	Пуэрто-Хименес , Коста-Рика		
АПК	Напаскиак аэропорт	Напаскиак , Аляска , США		
ПКБ	Региональный аэропорт Мид-Огайо-Вэлли	Паркерсбург , Западная Вирджиния , США		
ГЭС	Аэропорт Петропавловск-Камчатский (Аэропорт Елизово)	Петропавловск-Камчатский , Камчатский край , Россия.		
ПКД	Муниципальный аэропорт Парк-Рапидс (Коншок-Филд)	Парк-Рапидс , Миннесота , США		
ПКС	Аэропорт Паркс [1]	Паркс , Новый Южный Уэльс , Австралия		
ПКФ	Муниципальный аэропорт Парк-Фолс	Парк-Фолс , Висконсин , США		
МПА	Аэропорт Пангкор [1]	Остров Пангкор , Перак , Малайзия		
ГХЛ	Порто Чели аэропорт	Порто Чели (Портохелион), Греция		
ГПГ	Аэропорт Плайя-Гранде [1]	Плайя-Гранде , Гватемала		
ЫПУ	Аэропорт Пакокку [1]	Пакокку , Мьянма		
Аэропорт Порт-Каитума [1]	Порт Кайтума , Гайана		
АОИ	Аэропорт Искандар [1]	Пангкаланская булочка (Пангкаланбуун), Индонезия		
ББП	Аэропорт Параку	Параку , Бенин		
ТГП	Аэропорт Пука-Пука [1]	Пука-Пука , Туамотус , Французская Полинезия		
НПК	Аэропорт Покхара	Покхара , Непал		
КПТ	Аэродром Порт-Китс	Уэйдай (Порт-Китс), Северная территория , Австралия		
ИББ	Международный аэропорт Султана Шарифа Касима II	Пеканбару , Индонезия		
ЛОО	Псковский аэропорт	Псков , Псковская область , Россия		
БСП	Аэропорт Селеби-Пикве	Селеби-Фикве , Ботсвана		
БАД	Пекинский международный аэропорт Дасин	Пекин , Китай		
АГГ	Аэропорт Тджилик Ривут [1]	Палангкарая , Индонезия		
ЛПС	Международный аэропорт Паксе	Паксе , Лаос		
	Аэропорт Планадас [1]	Планадас , Колумбия		
Аэропорт Планета Рика [1]	Планета Рика , Колумбия		
РЦР	Аэропорт Каррильо [1] (Плайя Самара/Аэропорт Каррильо)	Самара / Пуэрто Каррильо , Коста-Рика		
Пайэла аэропорт	Пайэла , Папуа-Новая Гвинея		
ТТП	Аэропорт Пала [1]	Пала , Чад		
ГГД	Плимут Сити аэропорт	Плимут , Англия , Великобритания		
Аэропорт Палм-Айленд [1]	Палм-Айленд , Сент-Винсент и Гренадины		
ЗПЛ	Аэропорт Пласенсия	Пласенсия , Белиз		
ПЛК	Аэропорт М. Грэм Кларк Даунтаун	Пойнт-Лукаут , Миссури , США		
СБМН	База ВВС Манаус	Манаус , Амазонас , Бразилия		
ИПП	Международный аэропорт Султана Махмуда Бадаруддина II	Палембанг , Индонезия		
х	КПЛН	Региональный аэропорт Пеллстон (округ Эммет)	Пеллстон , Мичиган , США		
ПЛК	Порт-Линкольн: аэропорт	Порт-Линкольн , Южная Австралия , Австралия		
ПЛП	Аэропорт капитана Рамона Хатруха [1]	Ла Пальма , Панама		
YPA	Международный аэропорт Паланги	Паланга , Литва		
ПЛР	Аэропорт округа Сент-Клер	Пелл-Сити , Алабама , США		
уйста	МБПВ	Международный аэропорт Провиденсьялес	Провиденсиалес , Британская заморская территория
ва Тёркс и Кайкос		
КПЛ	Платон аэропорт [1]	Платон , Колумбия		
ББХ	Белу-Оризонти/Пампулья – Аэропорт Карлос Драммонд де Андраде	Белу-Оризонти , Минас-Жерайс , Бразилия		
ХП	Аэропорт Полтава [1]	Полтава , Украина		
АФФ	Аэропорт Мутиара [1]	Палу , Индонезия		
АСС	Аэропорт Семей	Семей , Казахстан		
Муниципальный аэропорт Плимута (FAA: C65)	Плимут , Индиана , США		
АПЕ	Аэропорт Порт-Элизабет	Порт-Элизабет , Южная Африка		
РА-
ВТЭ	Аэропорт Пемба [1]	Остров Пемба , Танзания		
ПМБ	Муниципальный аэропорт Пембина	Пембина , Северная Дакота , США		
КЭТ	Эль Тепуаль аэропорт	Пуэрто-Монт , Чили		
ПМД	Региональный аэропорт Палмдейл	Палмдейл , Калифорния , США		
РОМАТЬ	Аэропорт Пармы (аэропорт Джузеппе Верди)	Парма , Эмилия-Романья , Италия		
БПП	Международный аэропорт Понта Поран	Понта-Поран , Мату-Гросу-ду-Сул , Бразилия		
ПМХ	Региональный аэропорт Большого Портсмута	Портсмут , Огайо , США		
ЕПА	Аэропорт Пальма де Майорка	Пальма-де-Майорка , Балеарские острова , Испания		
ПАМ	Аэропорт Палм-Айленд [1]	Палм-Айленд , Квинсленд , Австралия		
ААЛ	Аэропорт Порт-Моллер (FAA: 1AK3)	Колд Бэй , Аляска , США		
Аэропорт Пумани [1]	Пумани , Папуа-Новая Гвинея		
ICJ	Аэропорт Фальконе-Борселлино (аэропорт Пунта Раиси)	Палермо , Сицилия , Италия		
Аэропорт Пимага	Пимага , Папуа-Новая Гвинея		
АРП	Перито Морено аэропорт	Перито Морено , Санта-Крус , Аргентина		
ЗПМ	Аэропорт Палмерстон Норт	Пальмерстон-Норт , Новая Зеландия		
СПР	Пальмира аэропорт	Пальмира (Тадмур), Сирия		
Аэропорт Парамакатой [1]	Парамакатои , Гайана		
ВМГ	Карибский международный аэропорт Сантьяго Мариньо	Порламар , Венесуэла		
БПЖ	Аэропорт Пальмас-Бригадейро Лисиас Родригес	Пальмас , Токантинс , Бразилия		
Столичный аэропорт [1] (FAA: 13MA)	Палмер , Массачусетс , США		
ЭВИ	Эль-Техуэльче: аэропорт	Пуэрто-Мадрин , Чубут , Аргентина		
РПМ	Пальмар-Сур: аэропорт	Пальмар-Сур , Коста-Рика		
ЕПП	Памплона аэропорт	Памплона , Наварра , Испания		
БПН	Национальный аэропорт Порту [1]	Порто Насьональ , Токантинс , Бразилия		
ПНК	Региональный аэропорт Понка-Сити	Понка-Сити , Оклахома , США		
ЗПГ	Аэропорт Пунта Горда [1]	Пунта Горда , Белиз		
ПНЕ	Северо-восточный аэропорт Филадельфии	Филадельфия , Пенсильвания , США		
СПГ	Аэропорт Сантос-Дюмон [1]	Паранагуа , Парана , Бразилия		
ДПП	Международный аэропорт Пномпеня	Пномпень , Камбоджа		
ТПН	Международный аэропорт Понпеи	Понпеи , Федеративные Штаты Микронезии		
Аэропорт Пэнлай Шахекоу [1]	Пэнлай , Шаньдун , Китай		
ИОО	Супадио аэропорт	Понтианак , Индонезия		
ИКГ	Аэропорт Пантеллерия [1]	Пантеллерия , Сицилия , Италия		
ПНН	Муниципальный аэропорт Принстона	Принстон , Мэн , США		
ЙГР	Аэропорт Гируа [1]	Попондетта , Папуа-Новая Гвинея		
АПО	Пуна аэропорт	Пуна , Махараштра , Индия		
рование	ФЦПП	Пуэнт-Нуар: аэропорт	Пуэнт-Нуар , Республика Конго		
ПНС	Международный аэропорт Пенсакола	Пенсакола , Флорида , США		
НТ	Аэропорт Теньенте Хулио Галлардо	Пуэрто-Наталес , Чили		
Муниципальный аэропорт Пангитч (FAA: U55)	Пангитч , Юта , США		
ЮПП	Авиабаза Паневежис [1] (аэропорт Паюостис)	Паневежис , Литва		
КГИИ	Региональный аэропорт Северного Техаса (FAA: GYI)	Шерман / Денисон , Техас , США	UTC-06:00	март-ноябрь
ОЛОСОВАНИЕ	Пудучерри аэропорт	Пондичерри , Пудучерри , Индия		
БПЛ	Аэропорт Сенадор Нило Коэльо	Петролина , Пернамбуку , Бразилия		
енность на доступ	SBPA	Международный аэропорт Салгаду Филью	Порту-Алегри , Риу-Гранди-ду-Сул , Бразилия		
ПОБ	Поуп Филд (ВВС Поуп)	Форт Либерти , Северная Каролина , США		
ПОК	Брэкетт Филд	Ла Верн , Калифорния , США		
ОСП	Аэропорт Подор	Подор , Сенегал		
ПОЭ	Армейский аэродром Макс [3]	Форт Джонсон , Луизиана , США		
ПОФ	Муниципальный аэропорт Поплар Блафф	Поплар Блафф , Миссури , США		
ОГ	Международный аэропорт Порт-Жантиль	Порт-Жантиль , Габон		
ПОН	Муниципальный аэропорт Покахонтас	Покахонтас , Айова , США		
ЛПО	Аэропорт капитана Николаса Рохаса [1]	Потоси , Боливия		
НПД	Аэропорт Педро Перейра душ Сантуш	Патос-де-Минас , Минас-Жерайс , Бразилия		
QPB	Пемба аэропорт	Пемба , Мозамбик		
ЙПИ	Международный аэропорт Джексонс	Порт-Морсби , Папуа-Новая Гвинея		
ГПП	Аэропорт Поптун [1]	Поптун , Гватемала		
БПК	Аэропорт Посус-де-Калдас [1]	Посуш-де-Калдас , Минас-Жерайс , Бразилия		
ДПП	Международный аэропорт Грегорио Луперон	Сан-Фелипе-де-Пуэрто-Плата , Доминиканская Республика		
ФПО	Аэропорт Пори	Пори , Финляндия		
ерминал	ТТПП	Международный аэропорт Пиарко	Порт-оф-Спейн , Тринидад и Тобаго		
К	МККДЖ	Кен Джонс Аэродром	Порт-Антонио , Ямайка		
ПОУ	Аэропорт округа Датчесс	Покипси , Нью-Йорк , США		
ЗПВ	Авиабаза Прешов [1]	Прешов , Словакия		
опленный	ЛДЖПЗ	Порторож аэропорт	Порторож , Словения		
ЛФПТ	Понтуаз – Аэродром Кормей	Париж , Иль-де-Франс , Франция		
ПОИ	Муниципальный аэропорт Пауэлл	Пауэлл / Ловелл , Вайоминг , США		
ОКЗР	Аэропорт Познань-Лавица	Познань , Польша		
ППА	Перри Лефорс Филд	Пампа , Техас , США		
БДН	Аэропорт Президенти-Пруденти	Президенти-Пруденти , Сан-Паулу , Бразилия		
АПР	Проспект Крик аэропорт	Проспект-Крик , Аляска , США		
МПЭ	Международный аэропорт Пуэрто-Пеньяско	Пуэрто-Пеньяско , Сонора , Мексика		
ППФ	Аэропорт Три-Сити	Парсонс , Канзас , США		
ГТУ	Международный аэропорт Паго-Паго	Паго-Паго , Американское Самоа		
Аэропорт Параи-тепуи [1]	Параи-тепуи (Пераитепуй), Венесуэла		
ПИР	Аэропорт Порт-Пири	Порт-Пири , Южная Австралия , Австралия		
ВИГ	Аэропорт острова Панджанг [1]	Остров Панджанг , Индонезия		
ACP	Петропавловский аэропорт	Петропавловск (Петропавловск), Казахстан		
НПЛ	Аэропорт Пхаплу	Пхафлу , Непал		
ПМП	Аэропорт Помпано-Бич (FAA: PMP)	Помпано-Бич , Флорида , США		
КПП	Гильермо Леон Валенсия аэропорт	Попаян , Колумбия		
БПН	Аэропорт Уитсанди Кост	Прозерпина , Квинсленд , Австралия		
ЗПП	Аэропорт Капити Кост	Пляж Парапарауму , Новая Зеландия		
ИРОКИЙ	Аэропорт Туанку Тамбусай [1]	Пасир Пангараян (Pasir Pangarayan), Индонезия		
ПВП	Международный аэропорт Пуэрто-Принсеса	Пуэрто-Принсеса , Филиппины		
ТАА	Международный аэропорт Фааа	Папеэте , Таити , Французская Полинезия		
ЫПП	Аэропорт Папун [1]	Папун , Мьянма		
База гидросамолетов защиты порта (FAA: 19P)	Порт Протекшн , Аляска , США		
ГЭП	Папа Вестрей: аэропорт	Папа Вестрей , Шотландия , Великобритания		
Аэропорт Парам [1]	Парам , Папуа-Новая Гвинея		
НЗА	Аэропорт Посу-Алегри [1]	Позу-Алегри , Минас-Жерайс , Бразилия		
Аэропорт Пуэрто Паес [1]	Пуэрто Паес , Венесуэла		
ВПК	Международный аэропорт Фукуока	Остров Фукуок , Вьетнам		
База гидросамолетов Баттикалоа [1]	Баттикалоа , Шри-Ланка		
ПКИ	Региональный аэропорт Северного Мэна на Преск-Айле	Преск-Айл , Мэн , США		
МПК	Международный аэропорт Паленке [1]	Паленке , Чьяпас , Мексика		
ПМК	Порт-Маккуори: аэропорт	Порт-Маккуори , Новый Южный Уэльс , Австралия		
Пилотная станция аэропорта (FAA: 0AK)	Пилотная станция , Аляска , США		
ААП	Аэропорт имени генерала Хусто Хосе де Уркиса	Парана , Энтре-Риос , Аргентина		
ПРБ	Муниципальный аэропорт Пасо Роблес	Пасо Роблес , Калифорния , США		
НДР	Эрнест А. Лав Филд	Прескотт , Аризона , США		
ПДО	Аэропорт Парду [1]	Станция Парду , Западная Австралия , Австралия		
АРИТЕЛЬНО		Аэропорт Поре [1]	Поре , Колумбия		
КПР	Аэропорт Вацлава Гавела Прага	Прага , Чехия		
ЦП	Аэропорт Пхрэ	Пхрае , Таиланд		
СПП	Аэропорт острова Праслен	Остров Праслен , Сейшельские острова		
АПК	Аэропорт Приска [1]	Приска , Южная Африка		
ПММ	Портиман аэропорт	Портиман , Португалия		
КПР	Международный аэропорт Приштины Адем Джашари	Приштина , Косово		
ПРО	Муниципальный аэропорт Перри	Перри , Айова , США		
ФКО	Проприано аэропорт	Проприано , Корсика , Франция		
РВИ	Президентский аэропорт Роке Саенс Пенья	Президиум Роке Саенс Пенья , Чако , Аргентина		
ИПР	Аэропорт Паруйма	Паруима , Гайана		
ГГП	Аэропорт Параси [1]	Параси , Соломоновы Острова		
ЫПЫ	Аэропорт Пай [1]	Пьяй (Пром), Мьянма		
КПО	Аэропорт Пршеров [1]	Пршеров , Чехия		
Аэропорт Прентис (FAA: 5N2)	Прентис , Висконсин , США		
ПРХ	Кокс Филд	Париж , Техас , США		
ФАВБ	Вандербум аэропорт	Претория , Южная Африка		
Аэропорт Прайнвилля (FAA: S39)	Прайнвилл , Орегон , США		
ИРП	Международный аэропорт Пизы (аэропорт Галилео Галилей)	Пиза , Тоскана , Италия		
вязьбанк	КПСБ	Региональный аэропорт Среднего штата	Раш (тауншип, округ Центр , Пенсильвания , США)		
ПСК	Аэропорт Три-Ситис	Паско , Вашингтон , США		
ЭС	Аэропорт Порт-Саид [1]	Порт-Саид , Египет		
ЖПС	Аэропорт Мерседита	Понсе , Пуэрто-Рико		
ПСФ	Муниципальный аэропорт Питтсфилда	Питтсфилд , Массачусетс , США		
АПГ	Петербургский аэропорт Джеймса А. Джонсона	Петербург , Аляска , США		
ХО	Аэропорт Санкт-Петер-Ординг [1]	Санкт-Петер-Ординг , земля Шлезвиг-Гольштейн , Германия		
ППИ	Аэропорт Пасни [1]	Пасни , Пакистан		
АМП	Касигунджу аэропорт [1]	Посо , Индонезия		
ПСК	Аэропорт Нью-Ривер-Вэлли	Дублин , Вирджиния , США		
гипет	Аэропорт Перта (аэропорт Скоун)	Перт , Шотландия , Великобритания		
ПСМ	Международный аэропорт Портсмута в Пиз	Портсмут , Нью-Гэмпшир , США		
ПСН	Муниципальный аэропорт Палестины	Палестина , Техас , США		
КПС	Антонио Нариньо аэропорт	Пасто , Колумбия		
ПСП	Международный аэропорт Палм-Спрингс	Палм-Спрингс , Калифорния , США		
База гидросамолетов в Филадельфии (FAA: 9N2)	Филадельфия , Пенсильвания , США		
ИБП	Абруццо аэропорт	Пескара , Абруццо , Италия		
АРП	Аэропорт Генерала-Либертадора Хосе де Сан-Мартин	Посадас , Мисьонес , Аргентина		
питания	НВОП	Аэропорт Пангсума [1]	Путуссибау , Индонезия		
Взлетно-посадочная полоса Папа-Стор [1]	Папа Стоур , Шотландия , Великобритания		
НОС	Аэропорт Пассос [1]	Пассос , Минас-Жерайс , Бразилия		
ПССХ	Муниципальный аэропорт Паласиос	Паласиос , Техас , США		
ФАЛ	Порт Стэнли аэропорт	Стэнли , Британская заморская территория Фолклендские острова		
ЛПС	Международный аэропорт Пуэрто Суарес	Пуэрто Суарес , Боливия		
АЛЖ	Аэропорт Порт-Олсуорт (FAA: TPO)	Порт-Олсворт , Аляска , США		
ПТБ	Аэропорт округа Динвидди	Петербург , Вирджиния , США		
База гидросамолетов Порт-Алисы (FAA: 16K)	Порт-Алиса , Аляска , США		
ААП	База гидросамолетов Порт-Александр (FAA: AHP)	Порт-Александер , Аляска , США		
ФФО	Аэропорт Малоло Лайлай [1]	Малоло Лайлай , Фиджи		
АПП	Международный аэропорт Полокване	Полокване , Южная Африка		
АГН	Порт-Хейден: аэропорт	Порт-Хейден , Аляска , США		
ПОД	Портленд аэропорт	Портленд , Виктория , Австралия		
ПТК	Международный аэропорт округа Окленд	Понтиак , Мичиган , США		
ВПТ	Аэропорт Пальмарито [1]	Пальмарито , Венесуэла		
ПТН	Мемориальный аэропорт Гарри П. Уильямса	Паттерсон , Луизиана , США		
СПБ	Аэропорт Жувеналь Лурейру Кардозу [1]	Пато-Бранко , Парана , Бразилия		
ФФР	Международный аэропорт Пуэнт-а-Питр (аэропорт Ле Рэзе)	Пуэнт-а-Питр , Гваделупа		
НМЗ	Аэропорт Порту-де-Мос [1]	Порту-де-Мос , Пара , Бразилия		
ПТС	Муниципальный аэропорт Аткинсон	Питтсбург , Канзас , США		
ПТТ	Региональный аэропорт Пратт	Пратт , Канзас , США		
АРМ	Платиновый аэропорт	Платинум , Аляска , США		
ПТВ	Муниципальный аэропорт Портервилля	Портервилл , Калифорния , США		
ПТВ	Поле наследия	Поттстаун , Пенсильвания , США		
КПИ	Аэропорт Контадор [1]	Питалито , Колумбия		
ПТО	Международный аэропорт Токумен	Панама-Сити , Панама		
ЕПА	Аэропорт Рио-Амазонас	Шелл , Эквадор		
Аэропорт Пуас [1]	Пуас , Папуа-Новая Гвинея		
ПУБ	Мемориальный аэропорт Пуэбло	Пуэбло , Колорадо , США		
ПУК	Региональный аэропорт округа Карбон	Прайс , Юта , США		
ИЛА	Аэропорт Пуэрто Десеадо	Пуэрто-Десеадо , Санта-Крус , Аргентина		
ПОА	Аэропорт Пуэрто-Обалдия [1]	Пуэрто-Обальдия , Панама		
ФБП	Аэропорт По-Пиренеи	По , Аквитания , Франция		
YPAG	Аэропорт Порт-Огаста [1]	Порт-Огаста , Южная Австралия , Австралия		
Аэропорт Пурени	Пурени , Папуа-Новая Гвинея		
ДПК	Международный аэропорт Пунта-Кана	Пунта Кана , Доминиканская Республика		
ТГК	Пукаруа аэропорт	Пукаруа , Туамотус , Французская Полинезия		
База гидросамолетов в порту Пулсбо (FAA: 83Q)	Поулсбо , Вашингтон , США		
бур	ФЗОП	Аэропорт Пуния [1]	Пуния , Демократическая Республика Конго		
	ДФКП	Аэропорт По	По , Буркина-Фасо		
CCI	Международный аэропорт Президенте Карлоса Ибаньеса дель Кампо	Пунта-Аренас , Чили		
ЛПР	Аэропорт Пуэрто-Рико [1]	Пуэрто-Рико , Боливия		
РКПК	Международный аэропорт Кимхэ	Пусан , Южная Корея		
АТЬ	ВОПН	Аэропорт Шри Сатья Саи [1]	Путтапарти , Андхра-Прадеш , Индия		
КАС	Аэропорт Трес де Майо	Пуэрто-Асис , Колумбия		
ЗПП	Аэропорт Малабу [1]	Пум , Новая Каледония		
ПУВ	Пуллман – Московский региональный аэропорт	Пулман / Москва (ID) , Вашингтон , США		
SCPV	Аэропорт Эль-Мирадор [1]	Пуэрто-Варас , Чили		
ДПЛ	Аэропорт Пула	Пула , Хорватия		
НПК	Аэропорт Пуэрто Кабесас	Пуэрто Кабесас , Никарагуа		
КПВ	Эль Эмбрухо аэропорт	Остров Провиденсия , Колумбия		
ПВХ	Муниципальный аэропорт Провинстаун	Провинстаун , Массачусетс , США		
ПВД	Аэропорт штата Теодор Фрэнсис Грин	Провиденс , Род-Айленд , США		
ПВР	Аэропорт Эль-Порвенир [1]	Эль-Порвенир , Панама		
ПВФ	Аэропорт Плейсервилл	Плейсервилл , Калифорния , США		
СПД	Международный аэропорт Шанхай Пудун	Шанхай , Китай		
БПВ	Международный аэропорт губернатора Хорхе Тейшейра де Оливейра	Порту-Велью , Рондония , Бразилия		
СПИ	Аэропорт Эду Чавес [1]	Паранаваи , Парана , Бразилия		
ГПЗ	Национальный аэропорт Актион	Превеза / Лефкас , Греция		
ПБКС	Аэропорт округа Пайк [1] ​​(FAA: PBX)	Пайквилл , Кентукки , США		
ЭПВ	Аэропорт Реалес Тамариндос	Портовьехо , Эквадор		
МПР	Международный аэропорт Лиценсиадо Густаво Диас Ордас	Пуэрто-Вальярта , Халиско , Мексика		
ГМД	Аэропорт Провидения Бэй	Провидения , Чукотка , Россия		
ПВУ	Муниципальный аэропорт Прово	Прово , Юта , США		
ПВВ	Аэропорт округа Хейл	Плейнвью , Техас , США		
ПВА	Аэропорт Уайли Пост	Оклахома-Сити , Оклахома , США		
КПВД	Шер-Вуд аэропорт	Плентивуд , Монтана , США		
ХМП	Певек аэропорт	Певек , Чукотка , Россия		
Аэропорт Белес [1]	Пави , Эфиопия		
ПВК	Представительский аэропорт Чикаго	Чикаго , Иллинойс , США		
ICP	Аэропорт Вирасаба	Пурвокерто , Индонезия		
ПВМ	Портлендский международный реактивный порт	Портленд , Мэн , США		
YCP	Аэропорт Питтс-Таун [1]	Питтс-Таун , Крукед-Айленд , Багамские острова		
ЗКК	Аэропорт Пвето [1]	Пвето , Демократическая Республика Конго		
АСП	Павлодар аэропорт	Павлодар , Казахстан		
База гидросамолетов Порт-Уолтер [1]	Порт-Уолтер , Аляска , США		
ПВТ	Национальный аэропорт Бремертона	Бремертон , Вашингтон , США		
ПНА	Ральф Венц Филд (ФАУ: ПНА)	Пайндейл , Вайоминг , США		
ИПИ	Аэропорт Атунг Бунгсу [1]	Пагар Алам , Южная Суматра , Индонезия		
ПМХ	Аэропорт Проминент-Хилл [1]	Проминент-Хилл , Южная Австралия , Австралия		
Аэропорт Полакка (FAA: P10)	Полакка , Аризона , США		
МПС	Международный аэропорт Пуэрто-Эскондидо	Пуэрто-Эскондидо , Оахака , Мексика		
ППС	Порто Санто аэропорт	Остров Порту-Санту , Мадейра , Португалия		
ТУЖ	Аэропорт Сурин [1]	Сурин , Таиланд		
ВПК	Плейку аэропорт	Плейку , Вьетнам		
ВЛ	Аэропорт Веласкес [1]	Пуэрто Бояка , Колумбия		
ЭЙП	Аэропорт Джейпур [1]	Джейпур , Одиша , Индия		
Аэропорт Плайон-Чико	Укупсени (Плайон-Чико), Панама		
КПЮ	Аэропорт Тонгарева [1]	Атолл Пенрин , Острова Кука		
Аэропорт Пакьонг	Пакьонг , Сикким , Индия		
ВПА	Касике Арамаре аэропорт	Пуэрто-Аякучо , Венесуэла		
ПРП	Аэропорт Полярный	Полярный , Якутия , Россия.		
ИИП	Международный аэропорт Паям [1]	Карадж , Иран		
База гидросамолетов на острове Перри [1]	Перри-Айленд , Аляска , США		
ПИМ	Муниципальный аэропорт Плимута	Плимут , Массачусетс , США		
Аэропорт Паян [1]	Паян , Колумбия		
ЕНТЯБРЬ	Аэропорт Путумайо [1]	Пуэрто-эль-Кармен-де-Путумайо , Эквадор		
ГАД	Авиабаза Андравида [1]	Пиргос , Греция		
Парадайз Скайпарк [1] ​​(FAA: CA92)	Парадайз , Калифорния , США		
Аэропорт Явиза [1]	Явиза , Панама		
Аэропорт Пай	Пай , Таиланд		
КПЗ	Аэропорт Пас-де-Арипоро [1]	Пас де Арипоро , Колумбия		
АПМ	Аэропорт Питермарицбург	Питермарицбург , Южная Африка		
ЗБ	Аэропорт Жоб	Жоб , Пакистан		
УЖ	Аэропорт Паньчжихуа Баоаньин [1]	Паньчжихуа , Сычуань , Китай		
КПК	Аэродром острова Пукапука [1]	Остров Пукапука , Острова Кука		
асто задаваемые вопросы	Аэропорт Зулу Иньяла [1]	Финда , Южная Африка		
ВПР	Мануэль Карлос Пиар Аэропорт Гуаяна	Сьюдад-Гуаяна / Пуэрто-Ордас , Венесуэла		
КТС	Аэропорт Макеуэ [1]	Темуко , Чили		
SPN	Новый международный аэропорт Порт-Судана	Порт-Судан , Судан		
ЗПП	Аэропорт Пиешт